00000000000
11111101010
00000101010
01110111010
00010001010
11111101011
01000101000
01010101110
00010001000
01111111010
00000000010