00001000000
01101011100
01000000100
01011110100
00010000000
11010111101
00000100000
01111101110
01000000000
01000000010
00000000000